NO ./textures/north.xpm

F 220,100,0

SO ./textures/south.xpm
WE ./textures/west.xpm
EA ./textures/east.xpm


C 255,30,0

111111
100101
101001
110001
111111
