NO ./textures/north.xpm

F 256,100,0

SO ./textures/south.xpm
WE ./textures/west.xpm
EA ./textures/east.xpm


C 255,30,0

111111
100101
101001
1100N1
111111
